region,codigo_region,provincia,codigo_provincia,comuna,codigo_comuna,hombres,mujeres,total
ARICA Y PARINACOTA,15,ARICA,151,ARICA,15101,109389,111975,221364
ARICA Y PARINACOTA,15,ARICA,151,CAMARONES,15102,726,529,1255
ARICA Y PARINACOTA,15,PARINACOTA,152,PUTRE,15201,2054,711,2765
ARICA Y PARINACOTA,15,PARINACOTA,152,GENERAL LAGOS,15202,412,272,684
TARAPACÁ,1,IQUIQUE,11,IQUIQUE,1101,94897,96571,191468
TARAPACÁ,1,IQUIQUE,11,ALTO HOSPICIO,1107,54206,54169,108375
TARAPACÁ,1,DEL TAMARUGAL,14,POZO ALMONTE,1401,8987,6724,15711
TARAPACÁ,1,DEL TAMARUGAL,14,CAMIÑA,1402,657,593,1250
TARAPACÁ,1,DEL TAMARUGAL,14,COLCHANE,1403,995,733,1728
TARAPACÁ,1,DEL TAMARUGAL,14,HUARA,1404,1501,1229,2730
TARAPACÁ,1,DEL TAMARUGAL,14,PICA,1405,6550,2746,9296
ANTOFAGASTA,2,ANTOFAGASTA,21,ANTOFAGASTA,2101,181846,180027,361873
ANTOFAGASTA,2,ANTOFAGASTA,21,MEJILLONES,2102,8035,5432,13467
ANTOFAGASTA,2,ANTOFAGASTA,21,SIERRA GORDA,2103,8662,1524,10186
ANTOFAGASTA,2,ANTOFAGASTA,21,TALTAL,2104,7481,5836,13317
ANTOFAGASTA,2,EL LOA,22,CALAMA,2201,86049,79682,165731
ANTOFAGASTA,2,EL LOA,22,OLLAGÜE,2202,207,114,321
ANTOFAGASTA,2,EL LOA,22,SAN PEDRO DE ATACAMA,2203,6161,4835,10996
ANTOFAGASTA,2,TOCOPILLA,23,TOCOPILLA,2301,12481,12705,25186
ANTOFAGASTA,2,TOCOPILLA,23,MARÍA ELENA,2302,4092,2365,6457
ATACAMA,3,COPIAPÓ,31,COPIAPÓ,3101,76627,77310,153937
ATACAMA,3,COPIAPÓ,31,CALDERA,3102,9094,8568,17662
ATACAMA,3,COPIAPÓ,31,TIERRA AMARILLA,3103,7796,6223,14019
ATACAMA,3,CHAÑARAL,32,CHAÑARAL,3201,6270,5949,12219
ATACAMA,3,CHAÑARAL,32,DIEGO DE ALMAGRO,3202,7486,6439,13925
ATACAMA,3,HUASCO,33,VALLENAR,3301,25422,26495,51917
ATACAMA,3,HUASCO,33,ALTO DEL CARMEN,3302,2925,2374,5299
ATACAMA,3,HUASCO,33,FREIRINA,3303,3557,3484,7041
ATACAMA,3,HUASCO,33,HUASCO,3304,5243,4906,10149
COQUIMBO,4,ELQUI,41,LA SERENA,4101,105836,115218,221054
COQUIMBO,4,ELQUI,41,COQUIMBO,4102,109872,117858,227730
COQUIMBO,4,ELQUI,41,ANDACOLLO,4103,5519,5525,11044
COQUIMBO,4,ELQUI,41,LA HIGUERA,4104,2236,2005,4241
COQUIMBO,4,ELQUI,41,PAIGUANO,4105,2240,2257,4497
COQUIMBO,4,ELQUI,41,VICUÑA,4106,13792,13979,27771
COQUIMBO,4,CHOAPA,42,ILLAPEL,4201,14739,16109,30848
COQUIMBO,4,CHOAPA,42,CANELA,4202,4632,4461,9093
COQUIMBO,4,CHOAPA,42,LOS VILOS,4203,11061,10321,21382
COQUIMBO,4,CHOAPA,42,SALAMANCA,4204,15712,13635,29347
COQUIMBO,4,LIMARÍ,43,OVALLE,4301,53619,57653,111272
COQUIMBO,4,LIMARÍ,43,COMBARBALÁ,4302,6656,6666,13322
COQUIMBO,4,LIMARÍ,43,MONTE PATRIA,4303,15270,15481,30751
COQUIMBO,4,LIMARÍ,43,PUNITAQUI,4304,5452,5504,10956
COQUIMBO,4,LIMARÍ,43,RÍO HURTADO,4305,2138,2140,4278
VALPARAÍSO,5,VALPARAÍSO,51,VALPARAÍSO,5101,144945,151710,296655
VALPARAÍSO,5,VALPARAÍSO,51,CASABLANCA,5102,13346,13521,26867
VALPARAÍSO,5,VALPARAÍSO,51,CONCÓN,5103,20321,21831,42152
VALPARAÍSO,5,VALPARAÍSO,51,JUAN FERNÁNDEZ,5104,499,427,926
VALPARAÍSO,5,VALPARAÍSO,51,PUCHUNCAVÍ,5105,9358,9188,18546
VALPARAÍSO,5,VALPARAÍSO,51,QUINTERO,5107,15834,16089,31923
VALPARAÍSO,5,VALPARAÍSO,51,VIÑA DEL MAR,5109,158669,175579,334248
VALPARAÍSO,5,ISLA DE PASCUA,52,ISLA DE PASCUA,5201,3819,3931,7750
VALPARAÍSO,5,LOS ANDES,53,LOS ANDES,5301,33289,33419,66708
VALPARAÍSO,5,LOS ANDES,53,CALLE LARGA,5302,7328,7504,14832
VALPARAÍSO,5,LOS ANDES,53,RINCONADA,5303,5134,5073,10207
VALPARAÍSO,5,LOS ANDES,53,SAN ESTEBAN,5304,9303,9552,18855
VALPARAÍSO,5,PETORCA,54,LA LIGUA,5401,17340,18050,35390
VALPARAÍSO,5,PETORCA,54,CABILDO,5402,9467,9921,19388
VALPARAÍSO,5,PETORCA,54,PAPUDO,5403,3341,3015,6356
VALPARAÍSO,5,PETORCA,54,PETORCA,5404,4889,4937,9826
VALPARAÍSO,5,PETORCA,54,ZAPALLAR,5405,3704,3635,7339
VALPARAÍSO,5,QUILLOTA,55,QUILLOTA,5501,43537,46980,90517
VALPARAÍSO,5,QUILLOTA,55,CALERA,5502,24462,26092,50554
VALPARAÍSO,5,QUILLOTA,55,HIJUELAS,5503,9037,8951,17988
VALPARAÍSO,5,QUILLOTA,55,LA CRUZ,5504,10656,11442,22098
VALPARAÍSO,5,QUILLOTA,55,NOGALES,5506,10799,11321,22120
VALPARAÍSO,5,SAN ANTONIO,56,SAN ANTONIO,5601,44713,46637,91350
VALPARAÍSO,5,SAN ANTONIO,56,ALGARROBO,5602,6734,7083,13817
VALPARAÍSO,5,SAN ANTONIO,56,CARTAGENA,5603,11265,11473,22738
VALPARAÍSO,5,SAN ANTONIO,56,EL QUISCO,5604,7826,8129,15955
VALPARAÍSO,5,SAN ANTONIO,56,EL TABO,5605,6682,6604,13286
VALPARAÍSO,5,SAN ANTONIO,56,SANTO DOMINGO,5606,5428,5472,10900
VALPARAÍSO,5,SAN FELIPE DE ACONCAGUA,57,SAN FELIPE,5701,37219,39625,76844
VALPARAÍSO,5,SAN FELIPE DE ACONCAGUA,57,CATEMU,5702,6982,7016,13998
VALPARAÍSO,5,SAN FELIPE DE ACONCAGUA,57,LLAILLAY,5703,12216,12392,24608
VALPARAÍSO,5,SAN FELIPE DE ACONCAGUA,57,PANQUEHUE,5704,3677,3596,7273
VALPARAÍSO,5,SAN FELIPE DE ACONCAGUA,57,PUTAENDO,5705,8358,8396,16754
VALPARAÍSO,5,SAN FELIPE DE ACONCAGUA,57,SANTA MARÍA,5706,7586,7655,15241
VALPARAÍSO,5,MARGA MARGA,58,QUILPUÉ,5801,71746,79962,151708
VALPARAÍSO,5,MARGA MARGA,58,LIMACHE,5802,22353,23768,46121
VALPARAÍSO,5,MARGA MARGA,58,OLMUÉ,5803,8597,8919,17516
VALPARAÍSO,5,MARGA MARGA,58,VILLA ALEMANA,5804,59756,66792,126548
METROPOLITANA DE SANTIAGO,13,SANTIAGO,131,SANTIAGO,13101,206678,197817,404495
METROPOLITANA DE SANTIAGO,13,SANTIAGO,131,CERRILLOS,13102,39631,41201,80832
METROPOLITANA DE SANTIAGO,13,SANTIAGO,131,CERRO NAVIA,13103,65438,67184,132622
METROPOLITANA DE SANTIAGO,13,SANTIAGO,131,CONCHALÍ,13104,61877,65078,126955
METROPOLITANA DE SANTIAGO,13,SANTIAGO,131,EL BOSQUE,13105,79372,83133,162505
METROPOLITANA DE SANTIAGO,13,SANTIAGO,131,ESTACIÓN CENTRAL,13106,73458,73583,147041
METROPOLITANA DE SANTIAGO,13,SANTIAGO,131,HUECHURABA,13107,48122,50549,98671
METROPOLITANA DE SANTIAGO,13,SANTIAGO,131,INDEPENDENCIA,13108,49186,51095,100281
METROPOLITANA DE SANTIAGO,13,SANTIAGO,131,LA CISTERNA,13109,43147,46972,90119
METROPOLITANA DE SANTIAGO,13,SANTIAGO,131,LA FLORIDA,13110,175693,191223,366916
METROPOLITANA DE SANTIAGO,13,SANTIAGO,131,LA GRANJA,13111,57025,59546,116571
METROPOLITANA DE SANTIAGO,13,SANTIAGO,131,LA PINTANA,13112,87044,90291,177335
METROPOLITANA DE SANTIAGO,13,SANTIAGO,131,LA REINA,13113,43599,49188,92787
METROPOLITANA DE SANTIAGO,13,SANTIAGO,131,LAS CONDES,13114,135917,158921,294838
METROPOLITANA DE SANTIAGO,13,SANTIAGO,131,LO BARNECHEA,13115,50500,55333,105833
METROPOLITANA DE SANTIAGO,13,SANTIAGO,131,LO ESPEJO,13116,49146,49658,98804
METROPOLITANA DE SANTIAGO,13,SANTIAGO,131,LO PRADO,13117,46799,49450,96249
METROPOLITANA DE SANTIAGO,13,SANTIAGO,131,MACUL,13118,55161,61373,116534
METROPOLITANA DE SANTIAGO,13,SANTIAGO,131,MAIPÚ,13119,250792,270835,521627
METROPOLITANA DE SANTIAGO,13,SANTIAGO,131,ÑUÑOA,13120,95409,112828,208237
METROPOLITANA DE SANTIAGO,13,SANTIAGO,131,PEDRO AGUIRRE CERDA,13121,49513,51661,101174
METROPOLITANA DE SANTIAGO,13,SANTIAGO,131,PEÑALOLÉN,13122,116882,124717,241599
METROPOLITANA DE SANTIAGO,13,SANTIAGO,131,PROVIDENCIA,13123,65710,76369,142079
METROPOLITANA DE SANTIAGO,13,SANTIAGO,131,PUDAHUEL,13124,112412,117881,230293
METROPOLITANA DE SANTIAGO,13,SANTIAGO,131,QUILICURA,13125,103456,106954,210410
METROPOLITANA DE SANTIAGO,13,SANTIAGO,131,QUINTA NORMAL,13126,53669,56357,110026
METROPOLITANA DE SANTIAGO,13,SANTIAGO,131,RECOLETA,13127,77709,80142,157851
METROPOLITANA DE SANTIAGO,13,SANTIAGO,131,RENCA,13128,72681,74470,147151
METROPOLITANA DE SANTIAGO,13,SANTIAGO,131,SAN JOAQUÍN,13129,45831,48661,94492
METROPOLITANA DE SANTIAGO,13,SANTIAGO,131,SAN MIGUEL,13130,50738,57216,107954
METROPOLITANA DE SANTIAGO,13,SANTIAGO,131,SAN RAMÓN,13131,40873,42027,82900
METROPOLITANA DE SANTIAGO,13,SANTIAGO,131,VITACURA,13132,38402,46982,85384
METROPOLITANA DE SANTIAGO,13,CORDILLERA,132,PUENTE ALTO,13201,275147,292959,568106
METROPOLITANA DE SANTIAGO,13,CORDILLERA,132,PIRQUE,13202,13429,13092,26521
METROPOLITANA DE SANTIAGO,13,CORDILLERA,132,SAN JOSÉ DE MAIPO,13203,9861,8328,18189
METROPOLITANA DE SANTIAGO,13,CHACABUCO,133,COLINA,13301,74635,71572,146207
METROPOLITANA DE SANTIAGO,13,CHACABUCO,133,LAMPA,13302,51545,50489,102034
METROPOLITANA DE SANTIAGO,13,CHACABUCO,133,TILTIL,13303,10047,9265,19312
METROPOLITANA DE SANTIAGO,13,MAIPO,134,SAN BERNARDO,13401,147800,153513,301313
METROPOLITANA DE SANTIAGO,13,MAIPO,134,BUIN,13402,47575,49039,96614
METROPOLITANA DE SANTIAGO,13,MAIPO,134,CALERA DE TANGO,13403,12718,12674,25392
METROPOLITANA DE SANTIAGO,13,MAIPO,134,PAINE,13404,36521,36238,72759
METROPOLITANA DE SANTIAGO,13,MELIPILLA,135,MELIPILLA,13501,61410,62217,123627
METROPOLITANA DE SANTIAGO,13,MELIPILLA,135,ALHUÉ,13502,3516,2928,6444
METROPOLITANA DE SANTIAGO,13,MELIPILLA,135,CURACAVÍ,13503,16222,16357,32579
METROPOLITANA DE SANTIAGO,13,MELIPILLA,135,MARÍA PINTO,13504,6830,6760,13590
METROPOLITANA DE SANTIAGO,13,MELIPILLA,135,SAN PEDRO,13505,5132,4594,9726
METROPOLITANA DE SANTIAGO,13,TALAGANTE,136,TALAGANTE,13601,36769,37468,74237
METROPOLITANA DE SANTIAGO,13,TALAGANTE,136,EL MONTE,13602,17793,18130,35923
METROPOLITANA DE SANTIAGO,13,TALAGANTE,136,ISLA DE MAIPO,13603,18051,18168,36219
METROPOLITANA DE SANTIAGO,13,TALAGANTE,136,PADRE HURTADO,13604,31452,31798,63250
METROPOLITANA DE SANTIAGO,13,TALAGANTE,136,PEÑAFLOR,13605,43944,46257,90201
LIBERTADOR GENERAL BERNARDO O'HIGGINS,6,CACHAPOAL,61,RANCAGUA,6101,117942,123832,241774
LIBERTADOR GENERAL BERNARDO O'HIGGINS,6,CACHAPOAL,61,CODEGUA,6102,6510,6478,12988
LIBERTADOR GENERAL BERNARDO O'HIGGINS,6,CACHAPOAL,61,COINCO,6103,3729,3630,7359
LIBERTADOR GENERAL BERNARDO O'HIGGINS,6,CACHAPOAL,61,COLTAUCO,6104,9806,9791,19597
LIBERTADOR GENERAL BERNARDO O'HIGGINS,6,CACHAPOAL,61,DOÑIHUE,6105,10394,10493,20887
LIBERTADOR GENERAL BERNARDO O'HIGGINS,6,CACHAPOAL,61,GRANEROS,6106,16634,16803,33437
LIBERTADOR GENERAL BERNARDO O'HIGGINS,6,CACHAPOAL,61,LAS CABRAS,6107,12656,11984,24640
LIBERTADOR GENERAL BERNARDO O'HIGGINS,6,CACHAPOAL,61,MACHALÍ,6108,25585,26920,52505
LIBERTADOR GENERAL BERNARDO O'HIGGINS,6,CACHAPOAL,61,MALLOA,6109,6819,6588,13407
LIBERTADOR GENERAL BERNARDO O'HIGGINS,6,CACHAPOAL,61,MOSTAZAL,6110,12663,12680,25343
LIBERTADOR GENERAL BERNARDO O'HIGGINS,6,CACHAPOAL,61,OLIVAR,6111,6822,6786,13608
LIBERTADOR GENERAL BERNARDO O'HIGGINS,6,CACHAPOAL,61,PEUMO,6112,7237,7076,14313
LIBERTADOR GENERAL BERNARDO O'HIGGINS,6,CACHAPOAL,61,PICHIDEGUA,6113,10080,9634,19714
LIBERTADOR GENERAL BERNARDO O'HIGGINS,6,CACHAPOAL,61,QUINTA DE TILCOCO,6114,6519,6483,13002
LIBERTADOR GENERAL BERNARDO O'HIGGINS,6,CACHAPOAL,61,RENGO,6115,28844,29981,58825
LIBERTADOR GENERAL BERNARDO O'HIGGINS,6,CACHAPOAL,61,REQUÍNOA,6116,14125,13843,27968
LIBERTADOR GENERAL BERNARDO O'HIGGINS,6,CACHAPOAL,61,SAN VICENTE,6117,23302,23464,46766
LIBERTADOR GENERAL BERNARDO O'HIGGINS,6,CARDENAL CARO,62,PICHILEMU,6201,8289,8105,16394
LIBERTADOR GENERAL BERNARDO O'HIGGINS,6,CARDENAL CARO,62,LA ESTRELLA,6202,1603,1438,3041
LIBERTADOR GENERAL BERNARDO O'HIGGINS,6,CARDENAL CARO,62,LITUECHE,6203,3287,3007,6294
LIBERTADOR GENERAL BERNARDO O'HIGGINS,6,CARDENAL CARO,62,MARCHIHUE,6204,3745,3563,7308
LIBERTADOR GENERAL BERNARDO O'HIGGINS,6,CARDENAL CARO,62,NAVIDAD,6205,3475,3166,6641
LIBERTADOR GENERAL BERNARDO O'HIGGINS,6,CARDENAL CARO,62,PAREDONES,6206,3220,2968,6188
LIBERTADOR GENERAL BERNARDO O'HIGGINS,6,COLCHAGUA,63,SAN FERNANDO,6301,36077,37896,73973
LIBERTADOR GENERAL BERNARDO O'HIGGINS,6,COLCHAGUA,63,CHÉPICA,6302,7577,7460,15037
LIBERTADOR GENERAL BERNARDO O'HIGGINS,6,COLCHAGUA,63,CHIMBARONGO,6303,17824,17575,35399
LIBERTADOR GENERAL BERNARDO O'HIGGINS,6,COLCHAGUA,63,LOLOL,6304,3471,3340,6811
LIBERTADOR GENERAL BERNARDO O'HIGGINS,6,COLCHAGUA,63,NANCAGUA,6305,8830,9003,17833
LIBERTADOR GENERAL BERNARDO O'HIGGINS,6,COLCHAGUA,63,PALMILLA,6306,6331,6151,12482
LIBERTADOR GENERAL BERNARDO O'HIGGINS,6,COLCHAGUA,63,PERALILLO,6307,5538,5469,11007
LIBERTADOR GENERAL BERNARDO O'HIGGINS,6,COLCHAGUA,63,PLACILLA,6308,4432,4306,8738
LIBERTADOR GENERAL BERNARDO O'HIGGINS,6,COLCHAGUA,63,PUMANQUE,6309,1751,1670,3421
LIBERTADOR GENERAL BERNARDO O'HIGGINS,6,COLCHAGUA,63,SANTA CRUZ,6310,18593,19262,37855
MAULE,7,TALCA,71,TALCA,7101,105622,114735,220357
MAULE,7,TALCA,71,CONSTITUCIÓN,7102,23005,23063,46068
MAULE,7,TALCA,71,CUREPTO,7103,4852,4596,9448
MAULE,7,TALCA,71,EMPEDRADO,7104,2199,1943,4142
MAULE,7,TALCA,71,MAULE,7105,24259,25462,49721
MAULE,7,TALCA,71,PELARCO,7106,4231,4191,8422
MAULE,7,TALCA,71,PENCAHUE,7107,4242,4003,8245
MAULE,7,TALCA,71,RÍO CLARO,7108,7246,6660,13906
MAULE,7,TALCA,71,SAN CLEMENTE,7109,21677,21592,43269
MAULE,7,TALCA,71,SAN RAFAEL,7110,4569,4622,9191
MAULE,7,CAUQUENES,72,CAUQUENES,7201,19314,21127,40441
MAULE,7,CAUQUENES,72,CHANCO,7202,4450,4478,8928
MAULE,7,CAUQUENES,72,PELLUHUE,7203,3765,3806,7571
MAULE,7,CURICÓ,73,CURICÓ,7301,72511,76625,149136
MAULE,7,CURICÓ,73,HUALAÑÉ,7302,4883,4774,9657
MAULE,7,CURICÓ,73,LICANTÉN,7303,3353,3300,6653
MAULE,7,CURICÓ,73,MOLINA,7304,22635,23341,45976
MAULE,7,CURICÓ,73,RAUCO,7305,5238,5246,10484
MAULE,7,CURICÓ,73,ROMERAL,7306,7624,7563,15187
MAULE,7,CURICÓ,73,SAGRADA FAMILIA,7307,9384,9160,18544
MAULE,7,CURICÓ,73,TENO,7308,14764,14157,28921
MAULE,7,CURICÓ,73,VICHUQUÉN,7309,2217,2105,4322
MAULE,7,LINARES,74,LINARES,7401,44671,48931,93602
MAULE,7,LINARES,74,COLBÚN,7402,10205,10560,20765
MAULE,7,LINARES,74,LONGAVÍ,7403,15482,15052,30534
MAULE,7,LINARES,74,PARRAL,7404,20165,21472,41637
MAULE,7,LINARES,74,RETIRO,7405,10054,9920,19974
MAULE,7,LINARES,74,SAN JAVIER,7406,22002,23545,45547
MAULE,7,LINARES,74,VILLA ALEGRE,7407,7880,8341,16221
MAULE,7,LINARES,74,YERBAS BUENAS,7408,9125,8956,18081
BIOBÍO,8,CONCEPCIÓN,81,CONCEPCIÓN,8101,107624,115950,223574
BIOBÍO,8,CONCEPCIÓN,81,CORONEL,8102,55799,60463,116262
BIOBÍO,8,CONCEPCIÓN,81,CHIGUAYANTE,8103,40505,45433,85938
BIOBÍO,8,CONCEPCIÓN,81,FLORIDA,8104,5386,5238,10624
BIOBÍO,8,CONCEPCIÓN,81,HUALQUI,8105,11843,12490,24333
BIOBÍO,8,CONCEPCIÓN,81,LOTA,8106,20950,22585,43535
BIOBÍO,8,CONCEPCIÓN,81,PENCO,8107,22617,24750,47367
BIOBÍO,8,CONCEPCIÓN,81,SAN PEDRO DE LA PAZ,8108,62941,68867,131808
BIOBÍO,8,CONCEPCIÓN,81,SANTA JUANA,8109,6751,6998,13749
BIOBÍO,8,CONCEPCIÓN,81,TALCAHUANO,8110,72993,78756,151749
BIOBÍO,8,CONCEPCIÓN,81,TOMÉ,8111,25919,29027,54946
BIOBÍO,8,CONCEPCIÓN,81,HUALPÉN,8112,43488,48285,91773
BIOBÍO,8,ARAUCO,82,LEBU,8201,12441,13081,25522
BIOBÍO,8,ARAUCO,82,ARAUCO,8202,17875,18382,36257
BIOBÍO,8,ARAUCO,82,CAÑETE,8203,16641,17896,34537
BIOBÍO,8,ARAUCO,82,CONTULMO,8204,3028,3003,6031
BIOBÍO,8,ARAUCO,82,CURANILAHUE,8205,15828,16460,32288
BIOBÍO,8,ARAUCO,82,LOS ÁLAMOS,8206,10203,10832,21035
BIOBÍO,8,ARAUCO,82,TIRÚA,8207,5195,5222,10417
BIOBÍO,8,BIOBÍO,83,LOS ÁNGELES,8301,97980,104351,202331
BIOBÍO,8,BIOBÍO,83,ANTUCO,8302,1975,2098,4073
BIOBÍO,8,BIOBÍO,83,CABRERO,8303,14174,14399,28573
BIOBÍO,8,BIOBÍO,83,LAJA,8304,10744,11645,22389
BIOBÍO,8,BIOBÍO,83,MULCHÉN,8305,14597,15030,29627
BIOBÍO,8,BIOBÍO,83,NACIMIENTO,8306,12962,13353,26315
BIOBÍO,8,BIOBÍO,83,NEGRETE,8307,4813,4924,9737
BIOBÍO,8,BIOBÍO,83,QUILACO,8308,2001,1987,3988
BIOBÍO,8,BIOBÍO,83,QUILLECO,8309,4720,4867,9587
BIOBÍO,8,BIOBÍO,83,SAN ROSENDO,8310,1661,1751,3412
BIOBÍO,8,BIOBÍO,83,SANTA BÁRBARA,8311,6699,7074,13773
BIOBÍO,8,BIOBÍO,83,TUCAPEL,8312,6876,7258,14134
BIOBÍO,8,BIOBÍO,83,YUMBEL,8313,10465,10733,21198
BIOBÍO,8,BIOBÍO,83,ALTO BIOBÍO,8314,3036,2887,5923
BIOBÍO,8,ÑUBLE * desde sept. 2018 región ÑUBLE,84,CHILLÁN *,8401,87521,97218,184739
BIOBÍO,8,ÑUBLE * desde sept. 2018 región ÑUBLE,84,BULNES *,8402,10382,11111,21493
BIOBÍO,8,ÑUBLE * desde sept. 2018 región ÑUBLE,84,COBQUECURA *,8403,2525,2487,5012
BIOBÍO,8,ÑUBLE * desde sept. 2018 región ÑUBLE,84,COELEMU *,8404,7873,8122,15995
BIOBÍO,8,ÑUBLE * desde sept. 2018 región ÑUBLE,84,COIHUECO *,8405,13424,13457,26881
BIOBÍO,8,ÑUBLE * desde sept. 2018 región ÑUBLE,84,CHILLÁN VIEJO *,8406,14581,16326,30907
BIOBÍO,8,ÑUBLE * desde sept. 2018 región ÑUBLE,84,EL CARMEN *,8407,5967,6077,12044
BIOBÍO,8,ÑUBLE * desde sept. 2018 región ÑUBLE,84,NINHUE *,8408,2567,2646,5213
BIOBÍO,8,ÑUBLE * desde sept. 2018 región ÑUBLE,84,ÑIQUÉN *,8409,5616,5536,11152
BIOBÍO,8,ÑUBLE * desde sept. 2018 región ÑUBLE,84,PEMUCO *,8410,4221,4227,8448
BIOBÍO,8,ÑUBLE * desde sept. 2018 región ÑUBLE,84,PINTO *,8411,5336,5491,10827
BIOBÍO,8,ÑUBLE * desde sept. 2018 región ÑUBLE,84,PORTEZUELO *,8412,2416,2446,4862
BIOBÍO,8,ÑUBLE * desde sept. 2018 región ÑUBLE,84,QUILLÓN *,8413,8664,8821,17485
BIOBÍO,8,ÑUBLE * desde sept. 2018 región ÑUBLE,84,QUIRIHUE *,8414,5679,5915,11594
BIOBÍO,8,ÑUBLE * desde sept. 2018 región ÑUBLE,84,RÁNQUIL *,8415,2842,2913,5755
BIOBÍO,8,ÑUBLE * desde sept. 2018 región ÑUBLE,84,SAN CARLOS *,8416,25425,27599,53024
BIOBÍO,8,ÑUBLE * desde sept. 2018 región ÑUBLE,84,SAN FABIÁN *,8417,2203,2105,4308
BIOBÍO,8,ÑUBLE * desde sept. 2018 región ÑUBLE,84,SAN IGNACIO *,8418,7882,8197,16079
BIOBÍO,8,ÑUBLE * desde sept. 2018 región ÑUBLE,84,SAN NICOLÁS *,8419,5796,5807,11603
BIOBÍO,8,ÑUBLE * desde sept. 2018 región ÑUBLE,84,TREGUACO *,8420,2703,2698,5401
BIOBÍO,8,ÑUBLE * desde sept. 2018 región ÑUBLE,84,YUNGAY *,8421,8964,8823,17787
LA ARAUCANÍA,9,CAUTÍN,91,TEMUCO,9101,134289,148126,282415
LA ARAUCANÍA,9,CAUTÍN,91,CARAHUE,9102,12202,12331,24533
LA ARAUCANÍA,9,CAUTÍN,91,CUNCO,9103,8765,8761,17526
LA ARAUCANÍA,9,CAUTÍN,91,CURARREHUE,9104,3821,3668,7489
LA ARAUCANÍA,9,CAUTÍN,91,FREIRE,9105,12413,12193,24606
LA ARAUCANÍA,9,CAUTÍN,91,GALVARINO,9106,6032,5964,11996
LA ARAUCANÍA,9,CAUTÍN,91,GORBEA,9107,6945,7469,14414
LA ARAUCANÍA,9,CAUTÍN,91,LAUTARO,9108,18448,19565,38013
LA ARAUCANÍA,9,CAUTÍN,91,LONCOCHE,9109,11502,12110,23612
LA ARAUCANÍA,9,CAUTÍN,91,MELIPEUCO,9110,3091,3047,6138
LA ARAUCANÍA,9,CAUTÍN,91,NUEVA IMPERIAL,9111,15870,16640,32510
LA ARAUCANÍA,9,CAUTÍN,91,PADRE LAS CASAS,9112,36996,39130,76126
LA ARAUCANÍA,9,CAUTÍN,91,PERQUENCO,9113,3395,3510,6905
LA ARAUCANÍA,9,CAUTÍN,91,PITRUFQUÉN,9114,12065,12772,24837
LA ARAUCANÍA,9,CAUTÍN,91,PUCÓN,9115,14106,14417,28523
LA ARAUCANÍA,9,CAUTÍN,91,SAAVEDRA,9116,6129,6321,12450
LA ARAUCANÍA,9,CAUTÍN,91,TEODORO SCHMIDT,9117,7526,7519,15045
LA ARAUCANÍA,9,CAUTÍN,91,TOLTÉN,9118,4883,4839,9722
LA ARAUCANÍA,9,CAUTÍN,91,VILCÚN,9119,13873,14278,28151
LA ARAUCANÍA,9,CAUTÍN,91,VILLARRICA,9120,27196,28282,55478
LA ARAUCANÍA,9,CAUTÍN,91,CHOLCHOL,9121,5773,5838,11611
LA ARAUCANÍA,9,MALLECO,92,ANGOL,9201,25613,27649,53262
LA ARAUCANÍA,9,MALLECO,92,COLLIPULLI,9202,12064,12534,24598
LA ARAUCANÍA,9,MALLECO,92,CURACAUTÍN,9203,8376,9037,17413
LA ARAUCANÍA,9,MALLECO,92,ERCILLA,9204,3817,3916,7733
LA ARAUCANÍA,9,MALLECO,92,LONQUIMAY,9205,5346,4905,10251
LA ARAUCANÍA,9,MALLECO,92,LOS SAUCES,9206,3607,3658,7265
LA ARAUCANÍA,9,MALLECO,92,LUMACO,9207,4927,4621,9548
LA ARAUCANÍA,9,MALLECO,92,PURÉN,9208,5677,6102,11779
LA ARAUCANÍA,9,MALLECO,92,RENAICO,9209,4957,5293,10250
LA ARAUCANÍA,9,MALLECO,92,TRAIGUÉN,9210,9019,9824,18843
LA ARAUCANÍA,9,MALLECO,92,VICTORIA,9211,16408,17774,34182
LOS RÍOS,14,VALDIVIA,141,VALDIVIA,14101,80348,85732,166080
LOS RÍOS,14,VALDIVIA,141,CORRAL,14102,2635,2667,5302
LOS RÍOS,14,VALDIVIA,141,LANCO,14103,8224,8528,16752
LOS RÍOS,14,VALDIVIA,141,LOS LAGOS,14104,9757,9877,19634
LOS RÍOS,14,VALDIVIA,141,MÁFIL,14105,3492,3603,7095
LOS RÍOS,14,VALDIVIA,141,MARIQUINA,14106,10607,10671,21278
LOS RÍOS,14,VALDIVIA,141,PAILLACO,14107,10067,10121,20188
LOS RÍOS,14,VALDIVIA,141,PANGUIPULLI,14108,17199,17340,34539
LOS RÍOS,14,RANCO,142,LA UNIÓN,14201,18729,19307,38036
LOS RÍOS,14,RANCO,142,FUTRONO,14202,7252,7413,14665
LOS RÍOS,14,RANCO,142,LAGO RANCO,14203,5045,4851,9896
LOS RÍOS,14,RANCO,142,RÍO BUENO,14204,15492,15880,31372
LOS LAGOS,10,LLANQUIHUE,101,PUERTO MONTT,10101,121019,124883,245902
LOS LAGOS,10,LLANQUIHUE,101,CALBUCO,10102,17104,16881,33985
LOS LAGOS,10,LLANQUIHUE,101,COCHAMÓ,10103,2195,1828,4023
LOS LAGOS,10,LLANQUIHUE,101,FRESIA,10104,6181,6080,12261
LOS LAGOS,10,LLANQUIHUE,101,FRUTILLAR,10105,9093,9335,18428
LOS LAGOS,10,LLANQUIHUE,101,LOS MUERMOS,10106,8681,8387,17068
LOS LAGOS,10,LLANQUIHUE,101,LLANQUIHUE,10107,8627,8964,17591
LOS LAGOS,10,LLANQUIHUE,101,MAULLÍN,10108,7231,6985,14216
LOS LAGOS,10,LLANQUIHUE,101,PUERTO VARAS,10109,21878,22700,44578
LOS LAGOS,10,CHILOÉ,102,CASTRO,10201,21471,22336,43807
LOS LAGOS,10,CHILOÉ,102,ANCUD,10202,19029,19962,38991
LOS LAGOS,10,CHILOÉ,102,CHONCHI,10203,7445,7413,14858
LOS LAGOS,10,CHILOÉ,102,CURACO DE VÉLEZ,10204,1853,1976,3829
LOS LAGOS,10,CHILOÉ,102,DALCAHUE,10205,6913,6849,13762
LOS LAGOS,10,CHILOÉ,102,PUQUELDÓN,10206,1973,1948,3921
LOS LAGOS,10,CHILOÉ,102,QUEILÉN,10207,2773,2612,5385
LOS LAGOS,10,CHILOÉ,102,QUELLÓN,10208,13857,13335,27192
LOS LAGOS,10,CHILOÉ,102,QUEMCHI,10209,4308,4044,8352
LOS LAGOS,10,CHILOÉ,102,QUINCHAO,10210,3941,4147,8088
LOS LAGOS,10,OSORNO,103,OSORNO,10301,77155,84305,161460
LOS LAGOS,10,OSORNO,103,PUERTO OCTAY,10302,4721,4278,8999
LOS LAGOS,10,OSORNO,103,PURRANQUE,10303,9976,10393,20369
LOS LAGOS,10,OSORNO,103,PUYEHUE,10304,5958,5709,11667
LOS LAGOS,10,OSORNO,103,RÍO NEGRO,10305,7051,7034,14085
LOS LAGOS,10,OSORNO,103,SAN JUAN DE LA COSTA,10306,4011,3501,7512
LOS LAGOS,10,OSORNO,103,SAN PABLO,10307,4978,5052,10030
LOS LAGOS,10,PALENA,104,CHAITÉN,10401,3016,2055,5071
LOS LAGOS,10,PALENA,104,FUTALEUFÚ,10402,1375,1248,2623
LOS LAGOS,10,PALENA,104,HUALAIHUÉ,10403,4701,4243,8944
LOS LAGOS,10,PALENA,104,PALENA,10404,886,825,1711
AYSÉN DEL GENERAL CARLOS IBÁÑEZ DEL CAMPO,11,COYHAIQUE,111,COYHAIQUE,11101,28763,29055,57818
AYSÉN DEL GENERAL CARLOS IBÁÑEZ DEL CAMPO,11,COYHAIQUE,111,LAGO VERDE,11102,494,358,852
AYSÉN DEL GENERAL CARLOS IBÁÑEZ DEL CAMPO,11,AYSÉN,112,AYSÉN,11201,12719,11240,23959
AYSÉN DEL GENERAL CARLOS IBÁÑEZ DEL CAMPO,11,AYSÉN,112,CISNES,11202,3922,2595,6517
AYSÉN DEL GENERAL CARLOS IBÁÑEZ DEL CAMPO,11,AYSÉN,112,GUAITECAS,11203,1166,677,1843
AYSÉN DEL GENERAL CARLOS IBÁÑEZ DEL CAMPO,11,CAPITÁN PRAT,113,COCHRANE,11301,1902,1588,3490
AYSÉN DEL GENERAL CARLOS IBÁÑEZ DEL CAMPO,11,CAPITÁN PRAT,113,O'HIGGINS,11302,374,251,625
AYSÉN DEL GENERAL CARLOS IBÁÑEZ DEL CAMPO,11,CAPITÁN PRAT,113,TORTEL,11303,285,238,523
AYSÉN DEL GENERAL CARLOS IBÁÑEZ DEL CAMPO,11,GENERAL CARRERA,114,CHILE CHICO,11401,2577,2288,4865
AYSÉN DEL GENERAL CARLOS IBÁÑEZ DEL CAMPO,11,GENERAL CARRERA,114,RÍO IBÁÑEZ,11402,1445,1221,2666
MAGALLANES Y DE LA ANTÁRTICA CHILENA,12,MAGALLANES,121,PUNTA ARENAS,12101,65538,66054,131592
MAGALLANES Y DE LA ANTÁRTICA CHILENA,12,MAGALLANES,121,LAGUNA BLANCA,12102,191,83,274
MAGALLANES Y DE LA ANTÁRTICA CHILENA,12,MAGALLANES,121,RÍO VERDE,12103,522,95,617
MAGALLANES Y DE LA ANTÁRTICA CHILENA,12,MAGALLANES,121,SAN GREGORIO,12104,619,180,799
MAGALLANES Y DE LA ANTÁRTICA CHILENA,12,ANTÁRTICA CHILENA,122,CABO DE HORNOS,12201,1195,868,2063
MAGALLANES Y DE LA ANTÁRTICA CHILENA,12,ANTÁRTICA CHILENA,122,ANTÁRTICA,12202,126,12,138
MAGALLANES Y DE LA ANTÁRTICA CHILENA,12,TIERRA DEL FUEGO,123,PORVENIR,12301,3993,2808,6801
MAGALLANES Y DE LA ANTÁRTICA CHILENA,12,TIERRA DEL FUEGO,123,PRIMAVERA,12302,930,228,1158
MAGALLANES Y DE LA ANTÁRTICA CHILENA,12,TIERRA DEL FUEGO,123,TIMAUKEL,12303,343,62,405
MAGALLANES Y DE LA ANTÁRTICA CHILENA,12,ÚLTIMA ESPERANZA,124,NATALES,12401,10992,10485,21477
MAGALLANES Y DE LA ANTÁRTICA CHILENA,12,ÚLTIMA ESPERANZA,124,TORRES DEL PAINE,12402,800,409,1209
